#........................................................#
#........................................................#
#........................................................#
#........................................................#
#.......................................................x#
#""""""""""""""""""""""""""""""""""""""""""""""""""""....#
#........................................................#
#........................................................#
#........................................................#
###......................................................#
#........""..............................................#
#........##..............................................#
#........................................................#
###......................................................#
#........................................................#
#........................................................#
#........................................................#
###......................................................#
#................x.......................................#
#...............###......................................#
#"""""""""""""#######""""""""""""""""""""""""""""""""""""#