#........................................................#
#........................................................#
#........................................................#
#........................................................#
#........................................................#
#........................................................#
#........................................................#
#........................................................#
#........................................................#
#........................................................#
#........................................................#
#........................................................#
#........................................................#
#........................................................#
#........................................................#
#........................................................#
#........................................................#
#........................................................#
#........................................................#
#........................................................#
#........................................................#
#........................................................#
#........................................................#
#.................................................x......#
##########################################################